16 16
1111111111111111
101000000001010S
1010111111110101
1010101000010101
1010101111010101
1010101101010101
1010000000000101
1010111111111101
1000000000000101
1011111111111101
1000000000100001
1011111111111101
1000100000000001
1011101111101101
1000000000000101
1111111111111111